#############################################################
# #                           #           #       #       # #
# # ################# ### ### # # ######### ##### # ### # # #
# #     #   #   #   #   #   # # #               #   #   # # #
# ##### # #         ### ### ### ##############     ## ### # #
#     #   #   #   #   #   #       # #     #     #     #   # #
##### ##### ### ##### ## ######## # # ### # ### # ##### ### #
#   #     #       #   #   #     #   #   # #   #   #     #   #
# # ##### # ### # # ### # # ### ### ### #            ## # ###
# #     # # #   # # #   #   #   # # # # #   # # #     # #   #
# ##### # # #              ## ### # # # ##            # ### #
# #     # #   #       # #   #   #     # #     # # # # #     #
# # #   # # ###      ## # ##### # ##### #### #### # # ##### #
#   #   # # #     # #   # #   # #   #   #           # # #   #
##### # # ### # ### # ### #           ### ##### ##### # # ###
#   # # #     # #   # #     # #     #   #   #         #   # #
# # # # ####### # ### ##### # ##### ### ### # ##### ##### # #
# # # # #   #     # #     # #     # #   #   #   #   #   # # #
# # # # ### # # ### # ### # ##### # # # # ##### ##### # # # #
# #   #     #   # #     # # #   # #   # # #   #     # # #   #
# ##### ####### # #                     # # ### ### # # ### #
#     # #     # # #           $         # #       # # # #   #
# ### ### # # # # #                   ### ### ##### # # # ###
# # # #   # # # #     #       # #       # #   #   #   # #   #
# # # # ### # # # ####### ### ########### # ### # ### # #####
#   #   # # # # # # #   #   #               #   #   # # #   #
### ##### # ### # # # # ### ########### ##### ##### ### # # #
#   #     #     #   # #   #     # #   #   #   #   # #   # # #
# ### ### ######### # ### ##### # # # ##        # # # ### # #
# #   #       #     # # #     #   # #   # #   #   # #     # #
# ##### ##### # ##### # ##### ##### ### ##### # # # # ##### #
#       #     # #   # #     #       #   #     # # # #   #   #
######            # # # # ########### ### ##### # # ### # ###
#               # #   # # #     #     # #   #   # #   # #   #
### ## #      ### ##### # # ### # #####            ## # ### #
#   #     # #     #     #   #   # #       #   # #     # #   #
# ### ####### ##### ######### ### # ###            #### # ###
#     #       #     #       # #   #         # # # #     #   #
# ####  ### #### #### ##### # # ##### ##### # # # #### #### #
#     #   # #   #     #       #   #   #   # # # #   #     # #
##### # # # # # # ############### # # # # ### # ### # ### # #
#   # # # #   # # #               # # # # #   #     # #   # #
# ### # # ##### # # ############### # # # # ### ##### # ### #
#       #       #                   #   #   #         #     #
#############################################################
